111001111111111001111010111100010100101101010111011101111011
111111110111111111111100111110111011111110101111111111111000
011101111100111011110111111100011111110111011111111111111110
111011001111111111010111011011001111111111000000101111110111
101111111111111111111111111110110111111111101111011011111111
101101101101011111011111111111101110001111101101101110111110
111111111111111111011110111110111111011101111100101111101100
011111110001111011110111111101101111100100001101011010101111
111111010101011011011010111110011111111110110111111111111101
111111111011110101111111011110111111110011111000111001101110
111111110111100111111111111001111111010111111100101111111011
011111111011101111111111101111111101010101111011111111111100
011110110111101010111011111011111111011011111101111111111111
110111011110111101110011001111100111111110001111111111111101
010110000110111111111111111101101101101111111111111110111101
100111111101011001010111011111011111101110111101101111110111
111111110110111111111111111101111111111111101111111111111001
111011011101111111010101011011110011111011110111111111111111
110111111100111110111110111110011111111111111110011111010111
101101111110111110111101111111010111111111101111101111110111
000101011011111111011111110110101011110010111011011111111111
110111111010111011111101110100010111010101111101011111111101
101010111111111111111111101110110101111111111111011111111101
111101110101001111101110011111111111101101110011111010010111
111110111110111101111111111010111111110110101111111111110101
111110111000101110110111111111011101111111111110111101111111
101110111011111111101100111110111110011111011111011110111100
011111101011111111111111100111111111111111110111011011111111
100111111111111010011000111111111111110111111011111011111110
011111111110110100111111010111011110011111101111111111111111
111101101111111101101011111101111101111111110100111011111111
111101101111011111111110101111111111101111111101111111111010
011111111110111010010111101111110110101111000101101011011101
101111111111011011111111011111101100111100101110111111011111
011011110111110111111111111110111111101110110101110101011011
101111100111100011111111111111111111111111111111011111011111
111111111111111111111110101001011111111110111110111111011101
101101001110100111111111011101110110111101111111101111111111
110110111100111111010101101000110101011111111110011011111110
100000110101101010110011111011011101111111101111111111111010
111111111111110111111111101101101111101111111110111111101101
010011111111111011111110100111111111110111110111111101110111
111101111111111111111111111101111011110010011111111111101111
111101111011001111111111110101010110011110111101111111111111
001101101100011111001110111111011111111011111111111111110111
111100011011111111101101101001111011011111111101111111011110
111111111011111101011111011111111010010010111111111111001111
111111110101111100110011111111111110101111111011101110001110
111111101111111011100111011100111111110111111101111111111111
111011011011101101101111111111010111110110110111111111010001
111010101011101111111101111110111011010011111011101111011111
010110111111110011011111111011111110111111110111111011111111
001011101111101101001111111101111000110110101100010111111001
011111111101010101111001111111001111110111011111001111010101
011111011110111111111111110011111100101111110111111010011111
111111101111101111111111111111111101011110111111101111011001
111111011111111111110011101111011110111100111011001111101010
011010011000110101110011111101101011011101111111110011111111
111111011111111111111011101101111101101111110111111011111110
111111101111011111111111111111101111101010110011101111110111
