00000000000010000001111111110011
01111111111110000001001000010010
00010001000010000001001000010010
00010001000010000000001000010010
00010001000010000001001000010010
00010001000010000001001000010010
11111111111111111111111111111110
10010001000010000001001000000100
10010001000010000001001000000101
10010001000010000001001011111101
10010001000010000001001000000101
11111111111110000001001000000101
10000000100010000001001000000101
10000000100010000001001111111111
10000000100010000001001000000101
10000000100010000001001000000101
11111111111111111111111100000101
10011110010010010001010100000101
10011110010010010001010111111101
10011110010010010001010100010001
10011110010010010001010100010001
10011110010010011001010100010000
10011110010010011001010100010001
11111111111110011001010100010001
10010001000010011001010100010001
10010001000010011001010100011111
10010001000010011001010100010001
10010001000010011001010100010000
11111111111111111111111100010001
00010000100010011001000100010001
00010000100010010001000100010001
00010000100010000001000100011111
