001010000000100010010011010110101000101101111100000001100100
011000001101111101101001001110011110110000111101000100011000
111010011111100001101010010011000111011100100100011000001010
010100001101001111010011000010001011011100100011001000000011
110001000001110010101011010111100101001001000001010111110101
110110001110011001101110010111100110110011010011111100111000
010010011010000000011111100101000001001110110101100111001011
000001100010100010111011101011010010010010000001011010110011
101001110001101000111011110111001111000101011101010111100100
111011110100001010111100010100001001110111111011010001000011
101111001011101001001100010110100011010111011111011101100101
011000111011010000000101101001100100110001100100000011101001
111011110101101101110111111010100011101001110100011010001101
101010111111111111011110111101011001010111000111110011001011
010010011111010100110000100010101101110001100000011011010111
000101001111111010000011110111010000100001111110100101001110
110001000000001000111110111000111111011000000100100011010010
110011001110111000000000001111001110010000011111110110010101
000000111011110110101001000111111111101100011000000100010001
111010100010010001101111101001110001111110010010111000110110
010001111010100111100101110100101011100000010111001010101111
100100000100101001110100000101100110111011000100011000010100
000000110010001100111110011011101001001000000101110101100010
001010010000100100100111101110010111100100111001010011100001
110111110000001100101110101110101110001001001000010110100011
000100111111100111001011000100100110001100011000010111010100
111101011110101100000111000010001001100000111011111100110110
110000101011000010111110000101110111101010010011000111110100
101000101000100011011110100010000101111101110111010111101110
111000111111100111000111110000001001011100001010011010101101
110111111001110000111001011110111100110010110110101011011100
100011011000110111110000010011000011011101111100011101101000
011111001100111101101100010110101110010110100010111101100110
111011011100010111110110000010111010101011110100001011011000
011111001000001101010100101000101000100111111010011001010100
010011110000110011011000001010011011100000011000101001001010
111101101000001101111001101111100010111111101010101100010101
101110101011101001100101010001111000001100010010100111000000
100111011111000100110010000100010010111000101111010011011101
100100101000110101101100101101110100101001110100100010000011
011000000100010111100010100000000000000011000110000001010000
101110111000111010011111010100110101101001100000011100101100
001101100101100111101010011111010110001111001010000101011100
101010011000101100011110001101001000011110000110101010010101
101011110100100101111000000101001100011111101011100011011001
000011000111010001010000111101101100010000001000101101101011
111111101100111010001011101101000110000111000111110011111000
110110001101110000011001000011000011100010101110111111001001
000010010100101000011011011001000001101101111110111000000110
110111001100001110100011000011010101001110110000110100000001
110011101111101110010001001000101001101010001110101101010110
011101011111101110100100001111011001100001110011000010010011
111100101100000110110000111011100011101010100111100100011101
011100100011010010011100011000000110010011110100101101101001
100101001000111101110101101111001010010110100000111101111010
000011011010011110110001000001011011000101110000111110000001
011000100000001010011001110000100110100000010010011110001010
111001110000100111001110100111100010001000010101010001111101
110010000000110001111111101110001000101101100101100010100111
100010110100011100001101101010101100101111101111101010100001
